red: 0,A
green: 1,B
++++++++++++++++++++++++++++
+a  ++++++++++++++++++   Bb+
+            1B            +
+0    +++     b    +++    A+
++++++++++++++++++++++++++++
