+++++++++++++++++++++
+ A             +++++
+   A        0+A+++++
+ A           +a+++++
+ A A  A A A  A++++++
+ A    A     A  +++++
+ A  A  A   A  A A  +
+ A    A     A A A  +
+ A  A  A   A  A A  +
+++++++++++++++++++++