+++++++++++
+0A       +
+AA       +
+         +
+         +
+        a+
+++++++++++