+++++++++++++++++++
+0                +
+              ++++
+              A  +
+            AA++A+
+            A A+a+
+++++++++++++++++++