+++++++++++++++++++
+0                +
+              ++++
+              A  +
+            AA++A+
+               +a+
+++++++++++++++++++