+++++++++++++++++++
+0A               +
+A             ++++
+                 +
+              ++ +
+               +a+
+++++++++++++++++++