red: 0,A
green: 1,B
+++++++++++++++++++++++
+a  BBBBB    A        +
+    0BBBB        1   +
+   BBBBB             +
+++++++++++++++++++++++
