red: 0,A
green: 1,B
+++++++++++++++++++++++
+a  BBBBB             +
+    0BBBB        1   +
+   BBBBB            A+
+++++++++++++++++++++++
