blue: 0,A
red: 1,B
++++++++++++
+B   01   A+
+          +
+          +
+    +a+   +
+    +b+   +
++++++++++++