red: 0,A
green: 1,B
+++++++++++++++++++++++
+a  +++++    A   B   b+
+    0B           1   +
+   +++++        B   b+
+++++++++++++++++++++++