++++++++++++++
+    AABAAA  +
+    AAAA    +
+    AAAAAAA +
+AAAAAAAAAAA +
+AAAAAAAAAAA +
+AAAAAAAAAAAA+
+            +
+            +
+            +
+      0     +
+     CC     +
+    CCCC    +
+   CCCCCC   +
+  CCCCCCCC  +
+ CCCCCCCCCC +
+CCCCCbCCCCCC+
++++++++++++++
